NO ./textures/simple_wall.xpm
SO ./textures/simple_wall.xpm
WE ./textures/simple_wall.xpm
EA ./textures/simple_wall.xpm

F 255,0,255
C 0,255,0

11111
10001
10S01
10001
11111
