NO ./textures/bookshelf.xpm
SO ./textures/pillar.xpm
WE ./textures/wall1.xpm
EA ./textures/wall1.xpm
F 255,0,255
C 255,255,255


1111
1E101
1111
