NO ./textures/simple_wall.xpm                            
SO ./textures/simple_wall.xpm             
WE ./textures/simple_wall.xpm
EA ./textures/simple_wall.xpm

F 255,255,0
C 0,255,0

11111111111111111
10000000000000N11
10000000000000011
11111111111111111
