NO ./textures/wall1.xpm             
SO ./textures/eagle.xpm    
WE ./textures/pillar.xpm         
EA ./textures/simple_wall.xpm

F 255,255,0
C 0,255,0

1111111111111111                 
10000000000000N11            
1000        0000000000011    
11111111111111111        
