NO ./textures/bookshelf.xpm
SO ./textures/pillar.xpm
WE ./textures/wall1.xpm
EA ./textures/wall1.xpm

F 255,0,255
C 255,255,255

1111111111                         1
1000000001                        101
10000000N1                         1
1000011111                   
100000000111111111111
100000000000000000001
100000000000000000001
100000000000000000001
100000000000000000001 
111111111111111111111
