NO ./textures/simple_wall.xpm
SO ./textures/simple_wall.xpm
WE ./textures/simple_wall.xpm
EA ./textures/simple_wall.xpm

F 255,0,255
C 0,255,0















1111111111
1000000001
100S000001
1000000001
100000000111111111111
100000000000000000001
100000000000000000001
100000000000000000001
100000000000000000001
111111111111111111111